file_name  , bbox, x1 , y1 , x2 , y2 , width, height, bbox_area, mask_area, drops
img0001.jpg,    0,   0,   0,   0,   0,     0,      0,         0,         0,     0
img0002.jpg,    0,  67, 116,  96, 155,    29,     39,      1131,       801,     1
img0002.jpg,    1, 126, 119, 146, 148,    20,     29,       580,       497,     1
img0002.jpg,    2, 330, 117, 352, 142,    22,     25,       550,       401,     1
img0002.jpg,    3, 449, 120, 467, 138,    18,     18,       324,       175,     1
img0003.jpg,    0,   0, 176,  50, 194,    50,     18,       900,       318,     1
img0003.jpg,    1,   0, 112,  43, 168,    43,     56,      2408,      2144,     1
img0003.jpg,    2,  47, 112, 103, 156,    56,     44,      2464,      1495,     2
img0003.jpg,    3, 248, 104, 308, 152,    60,     48,      2880,      1638,     2
img0003.jpg,    4, 361, 115, 454, 147,    93,     32,      2976,      2209,     4
img0003.jpg,    5, 751, 104, 768, 121,    17,     17,       289,       239,     1
img0003.jpg,    6, 766, 119, 800, 151,    34,     32,      1088,       718,     1
img0004.jpg,    0,   0, 175,  32, 194,    32,     19,       608,       348,     1
img0004.jpg,    1,   0, 118,  32, 161,    32,     43,      1376,      1021,     1
img0004.jpg,    2, 175, 104, 236, 160,    61,     56,      3416,      2175,     2
img0004.jpg,    3, 281, 102, 375, 149,    94,     47,      4418,      2732,     3
img0004.jpg,    4, 525, 114, 550, 145,    25,     31,       775,       652,     1
img0004.jpg,    5, 672,  97, 765, 160,    93,     63,      5859,      3504,     3
img0005.jpg,    0,   0, 167,  59, 194,    59,     27,      1593,       658,     0
img0005.jpg,    1,  62,  77, 298, 197,   236,    120,     28320,     19102,     5
img0005.jpg,    2, 435, 115, 466, 145,    31,     30,       930,       699,     1
img0005.jpg,    3, 494, 116, 513, 135,    19,     19,       361,       292,     1
img0005.jpg,    4, 580,  75, 706, 184,   126,    109,     13734,      9320,     1
img0005.jpg,    5, 774, 113, 800, 160,    26,     47,      1222,       641,     1
img0006.jpg,    0,   0,  76, 800, 198,   800,    122,     97600,     52258,     0
img0006.jpg,    1,  59,  56, 104,  78,    45,     22,       990,       502,     0
img0006.jpg,    2, 142, 201, 226, 217,    84,     16,      1344,       587,     0
img0006.jpg,    3, 225,  16, 245,  49,    20,     33,       660,       301,     0
img0006.jpg,    4, 271,   5, 292,  29,    21,     24,       504,       176,     0
img0006.jpg,    5, 315,   0, 358,  32,    43,     32,      1376,       507,     0
img0006.jpg,    6, 346, 115, 377, 146,    31,     31,       961,       764,     1
img0006.jpg,    7, 389, 117, 408, 136,    19,     19,       361,       272,     1
img0006.jpg,    8, 616, 215, 677, 237,    61,     22,      1342,       506,     0
img0006.jpg,    9, 719, 210, 752, 224,    33,     14,       462,       200,     0
img0006.jpg,   10, 721,   6, 736,  23,    15,     17,       255,       164,     0
img0006.jpg,   11, 748,   7, 767,  33,    19,     26,       494,       201,     0
img0006.jpg,   12, 756, 216, 800, 241,    44,     25,      1100,       224,     0
img0006.jpg,   13, 766,  31, 788,  45,    22,     14,       308,       193,     0
img0007.jpg,    0,   0,  76, 249, 197,   249,    121,     30129,     20515,     0
img0007.jpg,    1,  62,  56,  90,  78,    28,     22,       616,       314,     0
img0007.jpg,    2, 153, 203, 209, 217,    56,     14,       784,       401,     0
img0007.jpg,    3, 189, 176, 219, 185,    30,      9,       270,       159,     0
img0007.jpg,    4, 204, 157, 239, 184,    35,     27,       945,       467,     0
img0007.jpg,    5, 207, 182, 336, 194,   129,     12,      1548,       840,     0
img0007.jpg,    6, 226,  11, 253,  41,    27,     30,       810,       215,     0
img0007.jpg,    7, 256, 104, 312, 148,    56,     44,      2464,      1530,     2
img0007.jpg,    8, 292,   0, 317,  16,    25,     16,       400,       201,     0
img0007.jpg,    9, 313,  12, 341,  31,    28,     19,       532,       190,     0
img0007.jpg,   10, 341,   8, 357,  26,    16,     18,       288,       113,     0
img0007.jpg,   11, 431, 178, 570, 198,   139,     20,      2780,      1880,     0
img0007.jpg,   12, 448, 103, 547, 154,    99,     51,      5049,      3257,    12
img0007.jpg,   13, 579,  76, 800, 193,   221,    117,     25857,     19644,     0
img0007.jpg,   14, 625, 220, 675, 237,    50,     17,       850,       307,     0
img0007.jpg,   15, 723,   7, 738,  25,    15,     18,       270,       140,     0
img0007.jpg,   16, 750,   3, 765,  28,    15,     25,       375,       201,     0
img0007.jpg,   17, 767,  31, 788,  45,    21,     14,       294,       138,     0
img0007.jpg,   18, 769, 217, 800, 231,    31,     14,       434,       101,     0
img0008.jpg,    0,   0, 111,  70, 159,    70,     48,      3360,      2450,     2
img0008.jpg,    1, 170, 111, 224, 151,    54,     40,      2160,      1397,     2
img0008.jpg,    2, 373, 115, 470, 153,    97,     38,      3686,      2468,     3
img0008.jpg,    3, 526, 116, 551, 145,    25,     29,       725,       584,     1
img0008.jpg,    4, 577, 118, 599, 133,    22,     15,       330,       178,     1
img0008.jpg,    5, 713, 103, 784, 165,    71,     62,      4402,      2303,     5
img0008.jpg,    6, 791, 128, 800, 162,     9,     34,       306,       245,     0
img0009.jpg,    0,  91, 119, 134, 151,    43,     32,      1376,       837,     2
img0009.jpg,    1, 296, 114, 391, 154,    95,     40,      3800,      2559,     3
img0009.jpg,    2, 435, 118, 460, 143,    25,     25,       625,       498,     1
img0009.jpg,    3, 481, 118, 502, 140,    21,     22,       462,       354,     1
img0009.jpg,    4, 656, 108, 683, 131,    27,     23,       621,       355,     1
img0009.jpg,    5, 716, 111, 742, 151,    26,     40,      1040,       459,     1
img0010.jpg,    0, 221, 104, 314, 159,    93,     55,      5115,      3209,     3
img0010.jpg,    1, 342, 117, 369, 145,    27,     28,       756,       595,     1
img0010.jpg,    2, 381, 118, 403, 141,    22,     23,       506,       378,     1
img0010.jpg,    3, 576, 116, 611, 136,    35,     20,       700,       514,     1
img0011.jpg,    0, 144, 104, 239, 160,    95,     56,      5320,      3514,     3
img0011.jpg,    1, 248, 115, 306, 148,    58,     33,      1914,      1289,     2
img0011.jpg,    2, 499, 116, 565, 153,    66,     37,      2442,      1563,     2
img0011.jpg,    3, 763, 112, 792, 163,    29,     51,      1479,       960,     1
img0012.jpg,    0,  72, 106, 218, 163,   146,     57,      8322,      4876,     5
img0012.jpg,    1, 425, 116, 530, 154,   105,     38,      3990,      2709,     3
img0012.jpg,    2, 696, 103, 735, 154,    39,     51,      1989,      1158,     1
img0013.jpg,    0,   3, 112, 141, 160,   138,     48,      6624,      3766,     5
img0013.jpg,    1, 142, 121, 165, 143,    23,     22,       506,       389,     1
img0013.jpg,    2, 348, 116, 477, 153,   129,     37,      4773,      3086,     4
img0013.jpg,    3, 633, 111, 671, 138,    38,     27,      1026,       631,     3
img0014.jpg,    0,   0, 116,  81, 159,    81,     43,      3483,      1594,     4
img0014.jpg,    1, 272, 105, 395, 155,   123,     50,      6150,      3550,     4
img0014.jpg,    2, 569, 117, 606, 147,    37,     30,      1110,       659,     1
img0014.jpg,    3, 678, 102, 712, 131,    34,     29,       986,       716,     1
img0015.jpg,    0, 113, 107, 224, 165,   111,     58,      6438,      4046,     4
img0015.jpg,    1, 411, 118, 456, 155,    45,     37,      1665,      1340,     1
img0015.jpg,    2, 527, 118, 563, 157,    36,     39,      1404,      1059,     1
img0015.jpg,    3, 572, 122, 593, 146,    21,     24,       504,       296,     1
img0015.jpg,    4, 770, 121, 793, 156,    23,     35,       805,       466,     1
img0016.jpg,    0,  47, 112, 150, 165,   103,     53,      5459,      3430,     4
img0016.jpg,    1, 337, 119, 385, 155,    48,     36,      1728,      1420,     1
img0016.jpg,    2, 458, 118, 530, 155,    72,     37,      2664,      2067,     2
img0016.jpg,    3, 592, 119, 614, 137,    22,     18,       396,       259,     3
img0017.jpg,    0,   0, 127,  16, 159,    16,     32,       512,       467,     1
img0017.jpg,    1,  21, 114,  79, 151,    58,     37,      2146,      1228,     2
img0017.jpg,    2, 265, 106, 314, 158,    49,     52,      2548,      1841,     1
img0017.jpg,    3, 389, 118, 462, 156,    73,     38,      2774,      2054,     2
img0017.jpg,    4, 508, 118, 542, 151,    34,     33,      1122,       872,     1
img0017.jpg,    5, 573, 124, 591, 138,    18,     14,       252,       146,     1
img0018.jpg,    0, 197, 105, 243, 160,    46,     55,      2530,      1958,     1
img0018.jpg,    1, 318, 119, 397, 157,    79,     38,      3002,      2193,     2
img0018.jpg,    2, 430, 120, 462, 152,    32,     32,      1024,       820,     1
img0018.jpg,    3, 480, 120, 509, 147,    29,     27,       783,       629,     1
img0018.jpg,    4, 534, 123, 556, 149,    22,     26,       572,       448,     1
img0018.jpg,    5, 744, 111, 775, 159,    31,     48,      1488,       417,     1
img0019.jpg,    0, 128, 107, 176, 164,    48,     57,      2736,      2170,     1
img0019.jpg,    1, 244, 106, 324, 159,    80,     53,      4240,      2823,     2
img0019.jpg,    2, 351, 120, 385, 152,    34,     32,      1088,       870,     1
img0019.jpg,    3, 394, 121, 424, 148,    30,     27,       810,       635,     1
img0019.jpg,    4, 451, 120, 480, 147,    29,     27,       783,       609,     1
img0019.jpg,    5, 680, 103, 724, 152,    44,     49,      2156,      1067,     1
img0020.jpg,    0,  64, 111, 109, 167,    45,     56,      2520,      1906,     1
img0020.jpg,    1, 173, 105, 248, 163,    75,     58,      4350,      3141,     2
img0020.jpg,    2, 267, 115, 339, 153,    72,     38,      2736,      1798,     2
img0020.jpg,    3, 368, 120, 396, 149,    28,     29,       812,       669,     1
img0020.jpg,    4, 615, 115, 673, 142,    58,     27,      1566,       767,     1
img0020.jpg,    5, 781, 120, 800, 158,    19,     38,       722,       545,     1
img0021.jpg,    0,   0, 113,  44, 165,    44,     52,      2288,      1625,     1
img0021.jpg,    1, 102, 107, 179, 165,    77,     58,      4466,      3329,     2
img0021.jpg,    2, 180, 110, 253, 158,    73,     48,      3504,      2226,     2
img0021.jpg,    3, 282, 118, 312, 150,    30,     32,       960,       749,     1
img0021.jpg,    4, 541, 119, 594, 152,    53,     33,      1749,       985,     1
img0021.jpg,    5, 593, 125, 614, 138,    21,     13,       273,       103,     1
img0021.jpg,    6, 716, 110, 745, 160,    29,     50,      1450,       993,     1
img0021.jpg,    7, 776, 121, 800, 149,    24,     28,       672,       469,     1
img0022.jpg,    0,  38, 112, 175, 160,   137,     48,      6576,      5211,     4
img0022.jpg,    1, 197, 112, 228, 152,    31,     40,      1240,       892,     1
img0022.jpg,    2, 251, 119, 264, 141,    13,     22,       286,       185,     1
img0022.jpg,    3, 472, 119, 547, 157,    75,     38,      2850,      2258,     3
img0022.jpg,    4, 647, 119, 681, 134,    34,     15,       510,       231,     1
img0022.jpg,    5, 704, 113, 722, 133,    18,     20,       360,       259,     1
img0023.jpg,    0,   0, 112,  97, 173,    97,     61,      5917,      3697,     3
img0023.jpg,    1, 113, 113, 168, 157,    55,     44,      2420,      1520,     2
img0023.jpg,    2, 402, 118, 498, 158,    96,     40,      3840,      2397,     2
img0023.jpg,    3, 575, 119, 609, 139,    34,     20,       680,       489,     1
img0023.jpg,    4, 624, 118, 645, 136,    21,     18,       378,       250,     1
img0023.jpg,    5, 786, 127, 800, 163,    14,     36,       504,       351,     1
img0024.jpg,    0,   0, 124,  16, 159,    16,     35,       560,       490,     1
img0024.jpg,    1,  38, 120,  90, 159,    52,     39,      2028,      1047,     2
img0024.jpg,    2,  94, 128, 110, 146,    16,     18,       288,       227,     1
img0024.jpg,    3, 333, 119, 430, 159,    97,     40,      3880,      2529,     3
img0024.jpg,    4, 499, 119, 561, 156,    62,     37,      2294,      1661,     2
img0024.jpg,    5, 722, 109, 751, 161,    29,     52,      1508,       855,     1
img0024.jpg,    6, 767, 120, 793, 159,    26,     39,      1014,       813,     1
img0025.jpg,    0, 262, 106, 360, 160,    98,     54,      5292,      3077,     3
img0025.jpg,    1, 427, 120, 495, 158,    68,     38,      2584,      1922,     2
img0025.jpg,    2, 528, 121, 550, 147,    22,     26,       572,       443,     1
img0025.jpg,    3, 656, 108, 728, 152,    72,     44,      3168,      1119,     2
img0026.jpg,    0, 192, 104, 290, 163,    98,     59,      5782,      3531,     3
img0026.jpg,    1, 352, 119, 423, 157,    71,     38,      2698,      1952,     2
img0026.jpg,    2, 436, 121, 462, 146,    26,     25,       650,       506,     1
img0026.jpg,    3, 581, 117, 650, 142,    69,     25,      1725,       940,     2
img0026.jpg,    4, 774, 125, 800, 163,    26,     38,       988,       551,     1
img0027.jpg,    0, 121, 105, 223, 165,   102,     60,      6120,      4028,     3
img0027.jpg,    1, 278, 107, 376, 159,    98,     52,      5096,      3015,     3
img0027.jpg,    2, 504, 119, 570, 155,    66,     36,      2376,      1664,     2
img0027.jpg,    3, 702, 116, 738, 154,    36,     38,      1368,       624,     2
img0027.jpg,    4, 766, 120, 794, 162,    28,     42,      1176,       921,     1
img0028.jpg,    0,  51, 109, 150, 167,    99,     58,      5742,      3610,     3
img0028.jpg,    1, 208, 106, 300, 162,    92,     56,      5152,      3386,     3
img0028.jpg,    2, 430, 120, 505, 157,    75,     37,      2775,      2156,     2
img0028.jpg,    3, 624, 121, 647, 139,    23,     18,       414,       206,     1
img0028.jpg,    4, 698, 106, 731, 153,    33,     47,      1551,       966,     1
img0028.jpg,    5, 770, 117, 800, 165,    30,     48,      1440,      1032,     1
img0029.jpg,    0,   0, 112,  80, 167,    80,     55,      4400,      2763,     3
img0029.jpg,    1, 134, 105, 227, 165,    93,     60,      5580,      3528,     3
img0029.jpg,    2, 353, 119, 428, 156,    75,     37,      2775,      2167,     2
img0029.jpg,    3, 529, 121, 556, 151,    27,     30,       810,       683,     1
img0029.jpg,    4, 629, 116, 657, 141,    28,     25,       700,       460,     1
img0029.jpg,    5, 707, 106, 743, 162,    36,     56,      2016,      1192,     1
img0030.jpg,    0,  64, 112, 154, 165,    90,     53,      4770,      3378,     3
img0030.jpg,    1, 278, 115, 352, 159,    74,     44,      3256,      2415,     2
img0030.jpg,    2, 442, 120, 502, 150,    60,     30,      1800,      1292,     2
img0030.jpg,    3, 550, 135, 571, 151,    21,     16,       336,       183,     1
img0030.jpg,    4, 569, 121, 586, 145,    17,     24,       408,       222,     1
img0030.jpg,    5, 638, 112, 672, 140,    34,     28,       952,       542,     1
img0031.jpg,    0, 117, 108, 188, 164,    71,     56,      3976,      3077,     2
img0031.jpg,    1, 255, 118, 314, 153,    59,     35,      2065,      1460,     2
img0031.jpg,    2, 384, 120, 423, 155,    39,     35,      1365,      1126,     1
img0031.jpg,    3, 475, 120, 517, 156,    42,     36,      1512,      1230,     1
img0031.jpg,    4, 572, 120, 617, 148,    45,     28,      1260,       481,     1
img0031.jpg,    5, 679, 112, 703, 131,    24,     19,       456,       265,     1
img0032.jpg,    0,  48, 112, 115, 164,    67,     52,      3484,      2617,     2
img0032.jpg,    1, 181, 111, 218, 161,    37,     50,      1850,      1404,     1
img0032.jpg,    2, 308, 119, 347, 156,    39,     37,      1443,      1194,     1
img0032.jpg,    3, 400, 119, 443, 156,    43,     37,      1591,      1272,     3
img0032.jpg,    4, 481, 120, 545, 153,    64,     33,      2112,      1656,     2
img0032.jpg,    5, 599, 117, 623, 139,    24,     22,       528,       303,     1
img0032.jpg,    6, 768, 119, 800, 167,    32,     48,      1536,      1293,     1
img0033.jpg,    0,   0, 118,  47, 167,    47,     49,      2303,      1425,     1
img0033.jpg,    1, 107, 112, 143, 164,    36,     52,      1872,      1403,     1
img0033.jpg,    2, 232, 106, 272, 159,    40,     53,      2120,      1578,     1
img0033.jpg,    3, 324, 119, 368, 157,    44,     38,      1672,      1317,     1
img0033.jpg,    4, 398, 120, 463, 153,    65,     33,      2145,      1565,     2
img0033.jpg,    5, 514, 119, 550, 154,    36,     35,      1260,       985,     1
img0033.jpg,    6, 704, 106, 752, 164,    48,     58,      2784,      1890,     1
img0034.jpg,    0,  37, 116,  69, 159,    32,     43,      1376,       973,     1
img0034.jpg,    1, 159, 110, 198, 164,    39,     54,      2106,      1598,     1
img0034.jpg,    2, 250, 114, 293, 160,    43,     46,      1978,      1516,     1
img0034.jpg,    3, 315, 119, 383, 155,    68,     36,      2448,      1734,     2
img0034.jpg,    4, 433, 120, 495, 156,    62,     36,      2232,      1352,     2
img0034.jpg,    5, 635, 104, 737, 157,   102,     53,      5406,      2510,     4
img0034.jpg,    6, 655, 140, 673, 160,    18,     20,       360,       280,     1
img0034.jpg,    7, 768, 120, 800, 162,    32,     42,      1344,       944,     1
img0035.jpg,    0,  85, 111, 122, 167,    37,     56,      2072,      1512,     1
img0035.jpg,    1, 176, 109, 220, 165,    44,     56,      2464,      1844,     1
img0035.jpg,    2, 230, 107, 300, 157,    70,     50,      3500,      2229,     2
img0035.jpg,    3, 352, 120, 415, 154,    63,     34,      2142,      1411,     2
img0035.jpg,    4, 561, 116, 665, 151,   104,     35,      3640,      1757,     4
img0035.jpg,    5, 694, 107, 728, 152,    34,     45,      1530,       838,     1
img0036.jpg,    0,  23, 115,  54, 164,    31,     49,      1519,       991,     1
img0036.jpg,    1, 103, 108, 218, 165,   115,     57,      6555,      4425,     3
img0036.jpg,    2, 271, 115, 334, 155,    63,     40,      2520,      1566,     2
img0036.jpg,    3, 483, 118, 560, 159,    77,     41,      3157,      2338,     2
img0036.jpg,    4, 568, 123, 592, 149,    24,     26,       624,       349,     1
img0036.jpg,    5, 623, 116, 651, 143,    28,     27,       756,       472,     1
img0037.jpg,    0,  34, 112, 137, 164,   103,     52,      5356,      3792,     1
img0037.jpg,    1, 191, 111, 250, 159,    59,     48,      2832,      1640,     3
img0037.jpg,    2, 408, 118, 523, 160,   115,     42,      4830,      3457,     2
img0037.jpg,    3, 537, 120, 569, 153,    32,     33,      1056,       674,     3
img0037.jpg,    4, 585, 122, 609, 138,    24,     16,       384,       221,     1
img0038.jpg,    0,   0, 116,  62, 167,    62,     51,      3162,      1781,     1
img0038.jpg,    1, 112, 112, 170, 161,    58,     49,      2842,      1787,     2
img0038.jpg,    2, 331, 118, 448, 159,   117,     41,      4797,      3500,     3
img0038.jpg,    3, 458, 119, 527, 156,    69,     37,      2553,      1837,     2
img0038.jpg,    4, 542, 127, 559, 147,    17,     20,       340,       209,     1
img0038.jpg,    5, 759, 110, 787, 165,    28,     55,      1540,       796,     1
img0039.jpg,    0,  37, 116,  89, 159,    52,     43,      2236,      1341,     1
img0039.jpg,    1, 256, 106, 373, 161,   117,     55,      6435,      4225,     3
img0039.jpg,    2, 377, 119, 473, 157,    96,     38,      3648,      2449,     3
img0039.jpg,    3, 673, 104, 737, 161,    64,     57,      3648,      1574,     2
img0039.jpg,    4, 769, 124, 800, 158,    31,     34,      1054,       787,     1
img0040.jpg,    0, 183, 104, 394, 167,   211,     63,     13293,      7717,     6
img0040.jpg,    1, 602, 115, 652, 142,    50,     27,      1350,       769,     1
img0040.jpg,    2, 687, 110, 713, 132,    26,     22,       572,       362,     1
img0040.jpg,    3, 714, 129, 734, 151,    20,     22,       440,       254,     1
img0041.jpg,    0, 111, 105, 333, 167,   222,     62,     13764,      8560,     6
img0041.jpg,    1, 347, 121, 363, 138,    16,     17,       272,       233,     1
img0041.jpg,    2, 525, 118, 573, 158,    48,     40,      1920,      1264,     1
img0041.jpg,    3, 568, 121, 585, 148,    17,     27,       459,       209,     1
img0041.jpg,    4, 593, 117, 629, 139,    36,     22,       792,       389,     1
img0041.jpg,    5, 765, 118, 800, 165,    35,     47,      1645,      1157,     1
img0042.jpg,    0,  41, 107, 258, 168,   217,     61,     13237,      8355,     7
img0042.jpg,    1, 251, 116, 268, 135,    17,     19,       323,       210,     1
img0042.jpg,    2, 449, 119, 551, 159,   102,     40,      4080,      2939,     3
img0042.jpg,    3, 693, 105, 732, 159,    39,     54,      2106,      1025,     1
img0043.jpg,    0,   0, 111, 196, 167,   196,     56,     10976,      7362,     7
img0043.jpg,    1, 375, 120, 479, 159,   104,     39,      4056,      2916,     3
img0043.jpg,    2, 478, 133, 498, 154,    20,     21,       420,       362,     1
img0043.jpg,    3, 624, 116, 657, 141,    33,     25,       825,       472,     1
img0043.jpg,    4, 670, 104, 705, 133,    35,     29,      1015,       741,     1
img0043.jpg,    5, 785, 120, 800, 151,    15,     31,       465,       302,     1
img0044.jpg,    0,   0, 113, 120, 167,   120,     54,      6480,      3795,     5
img0044.jpg,    1, 301, 119, 424, 160,   123,     41,      5043,      3399,     4
img0044.jpg,    2, 543, 122, 575, 152,    32,     30,       960,       548,     1
img0044.jpg,    3, 569, 120, 586, 144,    17,     24,       408,       222,     1
img0044.jpg,    4, 593, 117, 631, 139,    38,     22,       836,       482,     1
img0044.jpg,    5, 714, 116, 736, 151,    22,     35,       770,       564,     1
img0045.jpg,    0,  29, 128,  48, 155,    19,     27,       513,       331,     1
img0045.jpg,    1, 225, 106, 350, 161,   125,     55,      6875,      4127,     4
img0045.jpg,    2, 465, 120, 513, 157,    48,     37,      1776,      1328,     1
img0045.jpg,    3, 516, 119, 560, 158,    44,     39,      1716,      1316,     1
img0045.jpg,    4, 634, 120, 652, 138,    18,     18,       324,       196,     1
img0045.jpg,    5, 770, 123, 800, 160,    30,     37,      1110,       679,     1
img0046.jpg,    0, 152, 105, 275, 167,   123,     62,      7626,      4493,     4
img0046.jpg,    1, 388, 119, 434, 157,    46,     38,      1748,      1363,     1
img0046.jpg,    2, 440, 119, 488, 156,    48,     37,      1776,      1352,     1
img0046.jpg,    3, 544, 124, 564, 151,    20,     27,       540,       340,     1
img0046.jpg,    4, 660, 117, 710, 133,    50,     16,       800,       296,     1
img0046.jpg,    5, 719, 114, 738, 155,    19,     41,       779,       575,     1
img0047.jpg,    0,   0, 112, 112, 169,   112,     57,      6384,      3914,     4
img0047.jpg,    1, 220, 105, 267, 161,    47,     56,      2632,      1868,     1
img0047.jpg,    2, 271, 106, 319, 159,    48,     53,      2544,      1866,     1
img0047.jpg,    3, 352, 120, 387, 153,    35,     33,      1155,       924,     1
img0047.jpg,    4, 472, 120, 560, 155,    88,     35,      3080,      2315,     3
img0047.jpg,    5, 689, 107, 718, 131,    29,     24,       696,       367,     1
img0047.jpg,    6, 775, 120, 800, 167,    25,     47,      1175,       927,     1
img0048.jpg,    0,   0, 115,  16, 158,    16,     43,       688,       484,     1
img0048.jpg,    1, 144, 106, 263, 165,   119,     59,      7021,      4454,     3
img0048.jpg,    2, 265, 115, 302, 154,    37,     39,      1443,      1096,     1
img0048.jpg,    3, 385, 120, 484, 156,    99,     36,      3564,      2500,     3
img0048.jpg,    4, 708, 105, 747, 163,    39,     58,      2262,      1481,     1
img0048.jpg,    5, 768, 116, 800, 167,    32,     51,      1632,      1232,     1
img0049.jpg,    0,  72, 112, 119, 166,    47,     54,      2538,      1865,     1
img0049.jpg,    1, 121, 107, 217, 165,    96,     58,      5568,      3693,     3
img0049.jpg,    2, 303, 119, 422, 156,   119,     37,      4403,      2850,     4
img0049.jpg,    3, 528, 120, 560, 157,    32,     37,      1184,       911,     1
img0049.jpg,    4, 639, 109, 680, 140,    41,     31,      1271,       666,     1
img0049.jpg,    5, 696, 105, 736, 161,    40,     56,      2240,      1248,     1
img0050.jpg,    0,   4, 112, 136, 167,   132,     55,      7260,      5271,     4
img0050.jpg,    1, 219, 105, 340, 159,   121,     54,      6534,      3416,     4
img0050.jpg,    2, 448, 120, 487, 155,    39,     35,      1365,      1085,     1
img0050.jpg,    3, 561, 119, 607, 151,    46,     32,      1472,       645,     1
img0050.jpg,    4, 624, 114, 661, 143,    37,     29,      1073,       620,     1
img0050.jpg,    5, 707, 119, 740, 153,    33,     34,      1122,       602,     1
img0050.jpg,    6, 768, 123, 800, 154,    32,     31,       992,       773,     1
img0051.jpg,    0,   0, 113,  58, 167,    58,     54,      3132,      2184,     2
img0051.jpg,    1, 137, 109, 253, 161,   116,     52,      6032,      3512,     4
img0051.jpg,    2, 368, 120, 406, 155,    38,     35,      1330,      1086,     1
img0051.jpg,    3, 480, 119, 530, 158,    50,     39,      1950,      1575,     1
img0051.jpg,    4, 541, 120, 587, 153,    46,     33,      1518,       892,     1
img0051.jpg,    5, 656, 120, 683, 135,    27,     15,       405,       180,     1
img0051.jpg,    6, 715, 119, 728, 150,    13,     31,       403,       202,     1
img0052.jpg,    0,  58, 112, 170, 166,   112,     54,      6048,      3350,     4
img0052.jpg,    1, 288, 118, 326, 157,    38,     39,      1482,      1225,     1
img0052.jpg,    2, 401, 118, 452, 159,    51,     41,      2091,      1549,     1
img0052.jpg,    3, 463, 119, 549, 157,    86,     38,      3268,      2367,     2
img0052.jpg,    4, 574, 123, 595, 144,    21,     21,       441,       278,     1
img0052.jpg,    5, 786, 121, 800, 166,    14,     45,       630,       376,     1
img0053.jpg,    0,   0, 120,  21, 159,    21,     39,       819,       547,     1
img0053.jpg,    1,  26, 116,  85, 161,    59,     45,      2655,      1426,     3
img0053.jpg,    2, 208, 110, 245, 159,    37,     49,      1813,      1350,     1
img0053.jpg,    3, 322, 119, 373, 159,    51,     40,      2040,      1624,     1
img0053.jpg,    4, 384, 119, 463, 159,    79,     40,      3160,      2357,     2
img0053.jpg,    5, 473, 120, 558, 151,    85,     31,      2635,      1867,     3
img0053.jpg,    6, 716, 108, 800, 164,    84,     56,      4704,      2629,     3
img0054.jpg,    0, 129, 109, 166, 163,    37,     54,      1998,      1492,     1
img0054.jpg,    1, 244, 106, 295, 160,    51,     54,      2754,      2045,     1
img0054.jpg,    2, 304, 116, 473, 159,   169,     43,      7267,      4541,     5
img0054.jpg,    3, 539, 127, 555, 146,    16,     19,       304,       233,     1
img0054.jpg,    4, 641, 105, 732, 152,    91,     47,      4277,      1929,     3
img0054.jpg,    5, 657, 140, 673, 160,    16,     20,       320,       211,     1
img0055.jpg,    0,  52, 114,  88, 160,    36,     46,      1656,      1086,     1
img0055.jpg,    1, 167, 107, 220, 167,    53,     60,      3180,      2296,     1
img0055.jpg,    2, 224, 105, 385, 160,   161,     55,      8855,      5470,     5
img0055.jpg,    3, 433, 122, 457, 145,    24,     23,       552,       445,     1
img0055.jpg,    4, 562, 116, 651, 150,    89,     34,      3026,      1352,     4
img0056.jpg,    0,   0, 121,  15, 159,    15,     38,       570,       539,     1
img0056.jpg,    1,  95, 108, 143, 167,    48,     59,      2832,      2142,     1
img0056.jpg,    2, 147, 104, 303, 166,   156,     62,      9672,      6212,     5
img0056.jpg,    3, 329, 121, 353, 146,    24,     25,       600,       500,     1
img0056.jpg,    4, 480, 119, 568, 159,    88,     40,      3520,      2639,     4
img0056.jpg,    5, 575, 123, 607, 136,    32,     13,       416,       249,     1
img0057.jpg,    0,   0, 114, 168, 161,   168,     47,      7896,      6414,     1
img0057.jpg,    1, 303, 119, 445, 152,   142,     33,      4686,      4181,     1
img0057.jpg,    2, 483, 121, 511, 145,    28,     24,       672,       423,     1
img0057.jpg,    3, 641, 113, 706, 136,    65,     23,      1495,       613,     1
img0057.jpg,    4, 717, 117, 751, 158,    34,     41,      1394,       846,     1
img0058.jpg,    0,  16, 112,  74, 167,    58,     55,      3190,      2262,     1
img0058.jpg,    1,  96, 113, 160, 157,    64,     44,      2816,      1988,     2
img0058.jpg,    2, 176, 117, 203, 155,    27,     38,      1026,       695,     1
img0058.jpg,    3, 335, 119, 388, 158,    53,     39,      2067,      1731,     1
img0058.jpg,    4, 433, 119, 482, 158,    49,     39,      1911,      1516,     1
img0058.jpg,    5, 531, 117, 639, 156,   108,     39,      4212,      2521,     1
img0058.jpg,    6, 767, 120, 800, 164,    33,     44,      1452,      1094,     1
img0059.jpg,    0,   0, 127,  23, 159,    23,     32,       736,       473,     1
img0059.jpg,    1,  33, 120,  64, 159,    31,     39,      1209,       775,     1
img0059.jpg,    2,  80, 121, 103, 157,    23,     36,       828,       577,     1
img0059.jpg,    3, 253, 106, 305, 160,    52,     54,      2808,       212,    14
img0059.jpg,    4, 351, 119, 400, 158,    49,     39,      1911,      1528,     1
img0059.jpg,    5, 443, 119, 549, 159,   106,     40,      4240,      3695,     1
img0059.jpg,    6, 681, 104, 721, 133,    40,     29,      1160,       879,     1
img0059.jpg,    7, 774, 121, 800, 159,    26,     38,       988,       547,     1
img0060.jpg,    0, 174, 107, 225, 163,    51,     56,      2856,      2285,     1
img0060.jpg,    1, 270, 106, 319, 159,    49,     53,      2597,      1942,     1
img0060.jpg,    2, 357, 119, 464, 159,   107,     40,      4280,      3750,     1
img0060.jpg,    3, 368, 106, 448, 114,    80,      8,       640,       466,     2
img0060.jpg,    4, 601, 116, 645, 138,    44,     22,       968,      5791,     1
img0060.jpg,    5, 691, 110, 719, 132,    28,     22,       616,       286,     1
img0060.jpg,    6, 769, 126, 784, 150,    15,     24,       360,       265,     1
img0061.jpg,    0,  96, 108, 145, 164,    49,     56,      2744,      2310,     1
img0061.jpg,    1, 190, 105, 239, 161,    49,     56,      2744,      2147,     1
img0061.jpg,    2, 271, 106, 379, 161,   108,     55,      5940,      4776,     1
img0061.jpg,    3, 516, 119, 561, 159,    45,     40,      1800,      1463,     1
img0061.jpg,    4, 602, 119, 624, 138,    22,     19,       418,       266,     1
img0061.jpg,    5, 679, 107, 709, 133,    30,     26,       780,       497,     1
img0062.jpg,    0,  27, 112,  70, 167,    43,     55,      2365,      1637,     1
img0062.jpg,    1, 112, 106, 160, 165,    48,     59,      2832,      2234,     1
img0062.jpg,    2, 186, 103, 295, 166,   109,     63,      6867,      5352,     1
img0062.jpg,    3, 433, 120, 485, 158,    52,     38,      1976,      1591,     1
img0062.jpg,    4, 506, 119, 541, 151,    35,     32,      1120,       903,     1
img0062.jpg,    5, 593, 117, 625, 139,    32,     22,       704,       387,     1
img0062.jpg,    6, 664, 113, 696, 135,    32,     22,       704,       386,     1
img0062.jpg,    7, 765, 128, 777, 160,    12,     32,       384,       234,     1
img0063.jpg,    0,   0, 109, 111, 167,   111,     58,      6438,      4454,     1
img0063.jpg,    1, 256, 107, 340, 160,    84,     53,      4452,      3123,     2
img0063.jpg,    2, 405, 119, 446, 156,    41,     37,      1517,      1169,     1
img0063.jpg,    3, 473, 120, 513, 155,    40,     35,      1400,      1108,     1
img0063.jpg,    4, 574, 119, 615, 151,    41,     32,      1312,       772,     1
img0063.jpg,    5, 634, 120, 656, 143,    22,     23,       506,       373,     1
img0063.jpg,    6, 783, 135, 800, 167,    17,     32,       544,       393,     1
img0064.jpg,    0,   0, 120,  21, 167,    21,     47,       987,       786,     1
img0064.jpg,    1, 174, 107, 253, 168,    79,     61,      4819,      3507,     1
img0064.jpg,    2, 320, 121, 360, 159,    40,     38,      1520,      1227,     1
img0064.jpg,    3, 385, 122, 426, 158,    41,     36,      1476,      1139,     1
img0064.jpg,    4, 480, 121, 566, 161,    86,     40,      3440,      2556,     2
img0064.jpg,    5, 716, 112, 743, 160,    27,     48,      1296,       945,     1
img0065.jpg,    0,  95, 109, 171, 167,    76,     58,      4408,      3578,     2
img0065.jpg,    1, 234, 109, 275, 161,    41,     52,      2132,      1585,     1
img0065.jpg,    2, 299, 120, 339, 159,    40,     39,      1560,      1229,     1
img0065.jpg,    3, 396, 121, 512, 161,   116,     40,      4640,      3325,     3
img0065.jpg,    4, 542, 132, 560, 152,    18,     20,       360,       246,     1
img0065.jpg,    5, 639, 120, 661, 142,    22,     22,       484,       321,     1
img0065.jpg,    6, 720, 111, 755, 167,    35,     56,      1960,      1364,     1
img0066.jpg,    0,  20, 111,  90, 167,    70,     56,      3920,      2864,     2
img0066.jpg,    1, 150, 106, 191, 159,    41,     53,      2173,      1636,     1
img0066.jpg,    2, 212, 107, 252, 158,    40,     51,      2040,      1480,     1
img0066.jpg,    3, 311, 115, 424, 157,   113,     42,      4746,      3438,     3
img0066.jpg,    4, 321, 104, 360, 111,    39,      7,       273,       242,     1
img0066.jpg,    5, 434, 119, 462, 145,    28,     26,       728,       592,     1
img0066.jpg,    6, 546, 121, 573, 149,    27,     28,       756,       319,     1
img0066.jpg,    7, 641, 101, 689, 134,    48,     33,      1584,       756,     1
img0067.jpg,    0,   0, 120,  15, 163,    15,     43,       645,       608,     1
img0067.jpg,    1,  69, 112, 111, 165,    42,     53,      2226,      1568,     1
img0067.jpg,    2, 128, 107, 168, 163,    40,     56,      2240,      1643,     1
img0067.jpg,    3, 229, 104, 367, 159,   138,     55,      7590,      5129,     5
img0067.jpg,    4, 461, 116, 500, 152,    39,     36,      1404,      1071,     1
img0067.jpg,    5, 571, 115, 614, 146,    43,     31,      1333,       765,     1
img0067.jpg,    6, 779, 121, 800, 145,    21,     24,       504,       302,     1
img0068.jpg,    0,   0, 113,  33, 167,    33,     54,      1782,      1304,     1
img0068.jpg,    1,  49, 112,  88, 159,    39,     47,      1833,      1266,     1
img0068.jpg,    2, 151, 103, 284, 165,   133,     62,      8246,      5708,     4
img0068.jpg,    3, 377, 117, 416, 153,    39,     36,      1404,      1135,     1
img0068.jpg,    4, 480, 115, 560, 155,    80,     40,      3200,      2442,     3
img0069.jpg,    0,   0, 122,  15, 159,    15,     37,       555,       506,     1
img0069.jpg,    1,  75, 104, 207, 167,   132,     63,      8316,      5651,     4
img0069.jpg,    2, 294, 115, 333, 155,    39,     40,      1560,      1242,     1
img0069.jpg,    3, 399, 115, 485, 156,    86,     41,      3526,      2669,     2
img0069.jpg,    4, 500, 116, 530, 146,    30,     30,       900,       759,     1
img0069.jpg,    5, 712, 113, 725, 143,    13,     30,       390,       200,     1
img0070.jpg,    0,   5, 112, 128, 167,   123,     55,      6765,      4773,     4
img0070.jpg,    1, 213, 107, 251, 158,    38,     51,      1938,      1366,     1
img0070.jpg,    2, 319, 116, 437, 156,   118,     40,      4720,      3551,     3
img0070.jpg,    3, 331, 104, 369, 111,    38,      7,       266,       218,     1
img0070.jpg,    4, 445, 117, 476, 144,    31,     27,       837,       638,     1
img0070.jpg,    5, 491, 117, 519, 145,    28,     28,       784,       639,     1
img0070.jpg,    6, 765, 118, 800, 160,    35,     42,      1470,      1114,     1
img0071.jpg,    0,   0, 120,  17, 158,    17,     38,       646,       589,     1
img0071.jpg,    1,  25, 128,  54, 162,    29,     34,       986,       686,     1
img0071.jpg,    2, 134, 107, 172, 162,    38,     55,      2090,      1554,     1
img0071.jpg,    3, 240, 104, 383, 159,   143,     55,      7865,      5192,     4
img0071.jpg,    4, 390, 118, 420, 145,    30,     27,       810,       675,     1
img0071.jpg,    5, 448, 118, 476, 143,    28,     25,       700,       554,     1
img0071.jpg,    6, 510, 117, 536, 145,    26,     28,       728,       604,     1
img0071.jpg,    7, 581, 119, 607, 131,    26,     12,       312,       171,     1
img0071.jpg,    8, 683, 100, 740, 150,    57,     50,      2850,      1561,     2
img0071.jpg,    9, 766, 118, 791, 159,    25,     41,      1025,       716,     1
img0072.jpg,    0,  58, 114,  94, 159,    36,     45,      1620,      1210,     1
img0072.jpg,    1, 160, 104, 327, 162,   167,     58,      9686,      6750,     5
img0072.jpg,    2, 347, 117, 375, 146,    28,     29,       812,       644,     1
img0072.jpg,    3, 410, 117, 437, 145,    27,     28,       756,       581,     1
img0072.jpg,    4, 489, 117, 520, 148,    31,     31,       961,       773,     1
img0072.jpg,    5, 606, 112, 673, 136,    67,     24,      1608,       833,     1
img0072.jpg,    6, 685, 102, 719, 129,    34,     27,       918,       646,     1
img0073.jpg,    0,  37, 112, 255, 170,   218,     58,     12644,      9138,     6
img0073.jpg,    1, 465, 130, 657, 175,   192,     45,      8640,      5673,     7
img0074.jpg,    0,   0, 114, 116, 175,   116,     61,      7076,      4492,     5
img0074.jpg,    1, 119, 116, 169, 170,    50,     54,      2700,      1997,     1
img0074.jpg,    2, 380, 113, 622, 173,   242,     60,     14520,      7617,    10
img0074.jpg,    3, 727, 128, 758, 169,    31,     41,      1271,       811,     1
img0075.jpg,    0,   0, 120,  87, 169,    87,     49,      4263,      2936,     2
img0075.jpg,    1, 295, 112, 543, 172,   248,     60,     14880,      9316,     9
img0075.jpg,    2, 640, 144, 657, 167,    17,     23,       391,       284,     1
img0075.jpg,    3, 751, 124, 800, 169,    49,     45,      2205,      1641,     1
img0076.jpg,    0,   0, 127,  13, 175,    13,     48,       624,       441,     1
img0076.jpg,    1, 208, 112, 456, 173,   248,     61,     15128,      9972,     9
img0076.jpg,    2, 546, 136, 585, 167,    39,     31,      1209,       848,     1
img0076.jpg,    3, 585, 146, 606, 164,    21,     18,       378,       226,     1
img0076.jpg,    4, 670, 127, 767, 175,    97,     48,      4656,      3100,     4
img0077.jpg,    0, 128, 112, 369, 173,   241,     61,     14701,     10001,     9
img0077.jpg,    1, 455, 130, 492, 167,    37,     37,      1369,      1012,     1
img0077.jpg,    2, 495, 144, 514, 163,    19,     19,       361,       288,     1
img0077.jpg,    3, 586, 132, 657, 174,    71,     42,      2982,      1886,     1
img0077.jpg,    4, 667, 142, 688, 173,    21,     31,       651,       482,     1
img0078.jpg,    0,  48, 112, 284, 175,   236,     63,     14868,      9823,     9
img0078.jpg,    1, 362, 120, 422, 167,    60,     47,      2820,      1607,     2
img0078.jpg,    2, 498, 132, 608, 171,   110,     39,      4290,      3214,     4
img0078.jpg,    3, 700, 129, 768, 167,    68,     38,      2584,      1760,     2
img0079.jpg,    0,   0, 120,  91, 167,    91,     47,      4277,      2659,     3
img0079.jpg,    1, 161, 120, 217, 168,    56,     48,      2688,      1614,     2
img0079.jpg,    2, 308, 115, 420, 170,   112,     55,      6160,      4301,     3
img0079.jpg,    3, 495, 132, 568, 167,    73,     35,      2555,      1817,     2
img0079.jpg,    4, 775, 136, 800, 170,    25,     34,       850,       551,     1
img0080.jpg,    0,  73, 122, 126, 165,    53,     43,      2279,      1373,     2
img0080.jpg,    1, 221, 113, 335, 170,   114,     57,      6498,      4388,     3
img0080.jpg,    2, 399, 119, 475, 166,    76,     47,      3572,      2339,     2
img0080.jpg,    3, 518, 134, 579, 166,    61,     32,      1952,      1241,     2
img0080.jpg,    4, 690, 128, 746, 168,    56,     40,      2240,      1213,     2
img0081.jpg,    0,   0, 123,  36, 167,    36,     44,      1584,       965,     2
img0081.jpg,    1, 136, 112, 247, 172,   111,     60,      6660,      4462,     3
img0081.jpg,    2, 303, 117, 380, 166,    77,     49,      3773,      2671,     2
img0081.jpg,    3, 422, 121, 485, 167,    63,     46,      2898,      1730,     2
img0081.jpg,    4, 604, 140, 639, 164,    35,     24,       840,       346,     1
img0081.jpg,    5, 721, 124, 783, 171,    62,     47,      2914,      2366,     1
img0082.jpg,    0,  54, 116, 160, 170,   106,     54,      5724,      4027,     3
img0082.jpg,    1, 208, 120, 285, 166,    77,     46,      3542,      2707,     2
img0082.jpg,    2, 325, 119, 389, 166,    64,     47,      3008,      1939,     2
img0082.jpg,    3, 513, 134, 577, 169,    64,     35,      2240,      1504,     2
img0082.jpg,    4, 639, 128, 702, 174,    63,     46,      2898,      1776,     1
img0083.jpg,    0,   0, 120,  79, 175,    79,     55,      4345,      2835,     3
img0083.jpg,    1, 115, 120, 191, 167,    76,     47,      3572,      2711,     2
img0083.jpg,    2, 228, 120, 292, 167,    64,     47,      3008,      2021,     2
img0083.jpg,    3, 423, 117, 489, 168,    66,     51,      3366,      1930,     2
img0083.jpg,    4, 549, 132, 615, 172,    66,     40,      2640,      2138,     1
img0083.jpg,    5, 735, 128, 779, 171,    44,     43,      1892,      1590,     1
img0084.jpg,    0,  26, 121,  96, 163,    70,     42,      2940,      2155,     2
img0084.jpg,    1, 135, 121, 195, 167,    60,     46,      2760,      1904,     2
img0084.jpg,    2, 334, 118, 399, 168,    65,     50,      3250,      2049,     2
img0084.jpg,    3, 460, 130, 529, 171,    69,     41,      2829,      2367,     1
img0084.jpg,    4, 658, 121, 703, 173,    45,     52,      2340,      1351,     1
img0084.jpg,    5, 710, 127, 800, 169,    90,     42,      3780,      2467,     3
img0085.jpg,    0,  48, 121, 100, 167,    52,     46,      2392,      1491,     2
img0085.jpg,    1, 241, 119, 308, 168,    67,     49,      3283,      2112,     2
img0085.jpg,    2, 371, 116, 441, 170,    70,     54,      3780,      3183,     1
img0085.jpg,    3, 561, 131, 618, 173,    57,     42,      2394,      1755,     1
img0085.jpg,    4, 623, 132, 658, 170,    35,     38,      1330,      1043,     1
img0085.jpg,    5, 666, 121, 800, 169,   134,     48,      6432,      3971,     5
img0086.jpg,    0, 154, 117, 218, 172,    64,     55,      3520,      2099,     2
img0086.jpg,    1, 282, 115, 352, 169,    70,     54,      3780,      3216,     1
img0086.jpg,    2, 475, 130, 620, 171,   145,     41,      5945,      4275,     4
img0086.jpg,    3, 621, 133, 658, 167,    37,     34,      1258,       946,     1
img0086.jpg,    4, 664, 128, 765, 167,   101,     39,      3939,      2773,     5
img0087.jpg,    0,  66, 121, 128, 167,    62,     46,      2852,      1829,     2
img0087.jpg,    1, 192, 113, 263, 169,    71,     56,      3976,      3235,     1
img0087.jpg,    2, 385, 113, 656, 171,   271,     58,     15718,      8366,     8
img0087.jpg,    3, 680, 142, 702, 167,    22,     25,       550,       323,     1
img0088.jpg,    0,   0, 121,  44, 173,    44,     52,      2288,      1289,     1
img0088.jpg,    1, 107, 115, 175, 171,    68,     56,      3808,      3036,     1
img0088.jpg,    2, 297, 112, 611, 170,   314,     58,     18212,     10588,    11
img0088.jpg,    3, 730, 128, 790, 169,    60,     41,      2460,      1874,     2
img0089.jpg,    0,  24, 117,  87, 167,    63,     50,      3150,      2635,     1
img0089.jpg,    1, 208, 112, 518, 170,   310,     58,     17980,     11632,    10
img0089.jpg,    2, 643, 133, 665, 171,    22,     38,       836,       361,     1
img0089.jpg,    3, 664, 127, 710, 167,    46,     40,      1840,      1205,     1
img0089.jpg,    4, 714, 127, 793, 168,    79,     41,      3239,      2257,     3
img0090.jpg,    0,   0, 121,   9, 168,     9,     47,       423,       330,     1
img0090.jpg,    1, 121, 112, 426, 170,   305,     58,     17690,     12126,    10
img0090.jpg,    2, 547, 131, 618, 168,    71,     37,      2627,      2003,     2
img0090.jpg,    3, 620, 133, 658, 163,    38,     30,      1140,       727,     1
img0090.jpg,    4, 663, 128, 736, 171,    73,     43,      3139,      1549,     3
img0091.jpg,    0,  32, 112, 323, 170,   291,     58,     16878,     11683,    10
img0091.jpg,    1, 444, 127, 610, 171,   166,     44,      7304,      4474,     6
img0091.jpg,    2, 726, 130, 753, 169,    27,     39,      1053,       740,     1
img0092.jpg,    0,   0, 113, 230, 170,   230,     57,     13110,      8745,     8
img0092.jpg,    1, 350, 113, 516, 171,   166,     58,      9628,      5590,     5
img0092.jpg,    2, 520, 141, 544, 164,    24,     23,       552,       441,     1
img0092.jpg,    3, 637, 144, 656, 169,    19,     25,       475,       331,     1
img0092.jpg,    4, 746, 130, 779, 169,    33,     39,      1287,      1037,     1
img0093.jpg,    0,   0, 113, 137, 167,   137,     54,      7398,      4574,     6
img0093.jpg,    1, 255, 115, 449, 171,   194,     56,     10864,      6742,     7
img0093.jpg,    2, 539, 137, 570, 167,    31,     30,       930,       716,     1
img0093.jpg,    3, 665, 129, 697, 172,    32,     43,      1376,      1020,     1
img0093.jpg,    4, 715, 128, 780, 168,    65,     40,      2600,      1700,     2
img0094.jpg,    0,   0, 125,  51, 167,    51,     42,      2142,      1285,     1
img0094.jpg,    1, 161, 113, 355, 175,   194,     62,     12028,      6998,     7
img0094.jpg,    2, 443, 128, 475, 168,    32,     40,      1280,       986,     1
img0094.jpg,    3, 569, 133, 611, 171,    42,     38,      1596,      1256,     1
img0094.jpg,    4, 624, 133, 657, 170,    33,     37,      1221,       727,     1
img0094.jpg,    5, 669, 137, 690, 165,    21,     28,       588,       409,     1
img0094.jpg,    6, 781, 144, 800, 168,    19,     24,       456,       339,     1
img0095.jpg,    0,   0, 118, 146, 169,   146,     51,      7446,      4727,     6
img0095.jpg,    1, 231, 120, 265, 167,    34,     47,      1598,      1245,     1
img0095.jpg,    2, 368, 116, 488, 170,   120,     54,      6480,      3906,     3
img0095.jpg,    3, 575, 134, 608, 167,    33,     33,      1089,       892,     1
img0095.jpg,    4, 663, 129, 719, 171,    56,     42,      2352,      1451,     1
img0095.jpg,    5, 774, 136, 800, 175,    26,     39,      1014,       752,     1
img0096.jpg,    0,   0, 125,  56, 172,    56,     47,      2632,      1274,     1
img0096.jpg,    1, 275, 115, 404, 169,   129,     54,      6966,      4227,     3
img0096.jpg,    2, 478, 131, 512, 167,    34,     36,      1224,       968,     1
img0096.jpg,    3, 563, 133, 624, 170,    61,     37,      2257,      1600,     2
img0096.jpg,    4, 689, 121, 800, 172,   111,     51,      5661,      3177,     3
img0097.jpg,    0, 185, 113, 314, 168,   129,     55,      7095,      4423,     4
img0097.jpg,    1, 380, 120, 415, 167,    35,     47,      1645,      1255,     1
img0097.jpg,    2, 470, 131, 537, 169,    67,     38,      2546,      1960,     2
img0097.jpg,    3, 601, 134, 657, 171,    56,     37,      2072,      1345,     1
img0097.jpg,    4, 668, 128, 800, 170,   132,     42,      5544,      3324,     4
img0098.jpg,    0,  97, 113, 224, 171,   127,     58,      7366,      4458,     4
img0098.jpg,    1, 283, 118, 319, 167,    36,     49,      1764,      1277,     1
img0098.jpg,    2, 377, 117, 446, 169,    69,     52,      3588,      2502,     2
img0098.jpg,    3, 511, 131, 658, 172,   147,     41,      6027,      3654,     4
img0098.jpg,    4, 669, 131, 725, 167,    56,     36,      2016,      1329,     2
img0099.jpg,    0,  16, 117, 131, 167,   115,     50,      5750,      3825,     4
img0099.jpg,    1, 187, 120, 223, 167,    36,     47,      1692,      1239,     1
img0099.jpg,    2, 284, 115, 352, 169,    68,     54,      3672,      2624,     2
img0099.jpg,    3, 420, 113, 629, 170,   209,     57,     11913,      6113,     8
img0099.jpg,    4, 673, 123, 785, 171,   112,     48,      5376,      3075,     4
img0100.jpg,    0,   0, 122,  48, 167,    48,     45,      2160,      1083,     1
img0100.jpg,    1,  95, 120, 128, 168,    33,     48,      1584,      1152,     1
img0100.jpg,    2, 193, 118, 260, 169,    67,     51,      3417,      2595,     2
img0100.jpg,    3, 329, 115, 541, 171,   212,     56,     11872,      7308,     6
img0100.jpg,    4, 579, 131, 657, 167,    78,     36,      2808,      1617,     3
img0100.jpg,    5, 668, 129, 720, 165,    52,     36,      1872,      1248,     1
img0101.jpg,    0,   8, 127,  39, 167,    31,     40,      1240,       892,     1
img0101.jpg,    1, 104, 116, 167, 170,    63,     54,      3402,      2462,     2
img0101.jpg,    2, 239, 112, 448, 171,   209,     59,     12331,      8049,     6
img0101.jpg,    3, 484, 131, 620, 172,   136,     41,      5576,      3299,     5
img0102.jpg,    0, 150, 112, 354, 171,   204,     59,     12036,      8156,     6
img0102.jpg,    1, 389, 116, 530, 170,   141,     54,      7614,      4283,     5
img0102.jpg,    2, 714, 127, 800, 171,    86,     44,      3784,      2834,     3
img0103.jpg,    0,  65, 113, 262, 171,   197,     58,     11426,      7927,     6
img0103.jpg,    1, 294, 116, 439, 172,   145,     56,      8120,      4914,     5
img0103.jpg,    2, 628, 133, 659, 171,    31,     38,      1178,       725,     1
img0103.jpg,    3, 666, 127, 764, 170,    98,     43,      4214,      3040,     4
img0104.jpg,    0,   0, 117, 169, 176,   169,     59,      9971,      6690,     6
img0104.jpg,    1, 200, 113, 346, 172,   146,     59,      8614,      5121,     5
img0104.jpg,    2, 538, 129, 678, 170,   140,     41,      5740,      3559,     5
img0105.jpg,    0,   0, 121,  80, 167,    80,     46,      3680,      2580,     3
img0105.jpg,    1, 111, 113, 255, 173,   144,     60,      8640,      5069,     5
img0105.jpg,    2, 448, 128, 592, 171,   144,     43,      6192,      4527,     5
img0105.jpg,    3, 736, 127, 800, 171,    64,     44,      2816,      2403,     1
img0106.jpg,    0,  24, 118, 160, 170,   136,     52,      7072,      4342,     5
img0106.jpg,    1, 358, 115, 503, 170,   145,     55,      7975,      5442,     5
img0106.jpg,    2, 524, 135, 556, 166,    32,     31,       992,       784,     1
img0106.jpg,    3, 660, 121, 800, 175,   140,     54,      7560,      4659,     5
img0107.jpg,    0,   0, 121,  69, 167,    69,     46,      3174,      2020,     3
img0107.jpg,    1, 269, 115, 415, 170,   146,     55,      8030,      5951,     5
img0107.jpg,    2, 426, 118, 463, 166,    37,     48,      1776,      1222,     1
img0107.jpg,    3, 562, 131, 661, 175,    99,     44,      4356,      3064,     3
img0107.jpg,    4, 664, 128, 800, 168,   136,     40,      5440,      3892,     6
img0108.jpg,    0, 181, 113, 367, 172,   186,     59,     10974,      7633,     6
img0108.jpg,    1, 475, 131, 660, 172,   185,     41,      7585,      5635,     6
img0109.jpg,    0,  96, 112, 272, 173,   176,     61,     10736,      7532,     6
img0109.jpg,    1, 386, 112, 631, 171,   245,     59,     14455,      8156,     8
img0110.jpg,    0,  13, 114, 179, 175,   166,     61,     10126,      6851,     5
img0110.jpg,    1, 299, 114, 569, 170,   270,     56,     15120,      9546,    10
img0111.jpg,    0, 103, 121, 159, 163,    56,     42,      2352,      1776,     1
img0111.jpg,    1, 186, 120, 349, 165,   163,     45,      7335,      6282,     1
img0111.jpg,    2, 368, 125, 410, 161,    42,     36,      1512,      1101,     1
img0111.jpg,    3, 447, 135, 580, 165,   133,     30,      3990,      2432,     3
img0112.jpg,    0,   0, 116,  73, 175,    73,     59,      4307,      3552,     1
img0112.jpg,    1, 140, 120, 176, 167,    36,     47,      1692,      1261,     1
img0112.jpg,    2, 248, 114, 314, 169,    66,     55,      3630,      2934,     1
img0112.jpg,    3, 376, 117, 432, 169,    56,     52,      2912,      2347,     1
img0113.jpg,    0,  65, 120, 120, 167,    55,     47,      2585,      1773,     2
img0113.jpg,    1, 175, 112, 236, 170,    61,     58,      3538,      2939,     1
img0113.jpg,    2, 300, 115, 356, 169,    56,     54,      3024,      2426,     1
img0114.jpg,    0, 108, 112, 167, 171,    59,     59,      3481,      2715,     1
img0114.jpg,    1, 231, 113, 287, 170,    56,     57,      3192,      2539,     1
img0115.jpg,    0, 160, 113, 221, 170,    61,     57,      3477,      2638,     1
img0116.jpg,    0,  95, 113, 151, 170,    56,     57,      3192,      2401,     1
img0117.jpg,    0,   0,   0,   0,   0,     0,      0,         0,         0,     0
img0118.jpg,    0,   0,   0,   0,   0,     0,      0,         0,         0,     0
img0119.jpg,    0,   0,   0,   0,   0,     0,      0,         0,         0,     0
img0120.jpg,    0,   0,   0,   0,   0,     0,      0,         0,         0,     0
img0121.jpg,    0,   0,   0,   0,   0,     0,      0,         0,         0,     0
img0122.jpg,    0,   0,   0,   0,   0,     0,      0,         0,         0,     0
img0123.jpg,    0,   0,   0,   0,   0,     0,      0,         0,         0,     0
img0124.jpg,    0,   0,   0,   0,   0,     0,      0,         0,         0,     0
img0125.jpg,    0,   0,   0,   0,   0,     0,      0,         0,         0,     0
img0126.jpg,    0,   0,   0,   0,   0,     0,      0,         0,         0,     0
img0127.jpg,    0,   0,   0,   0,   0,     0,      0,         0,         0,     0
img0128.jpg,    0,   0,   0,   0,   0,     0,      0,         0,         0,     0
img0129.jpg,    0,   0,   0,   0,   0,     0,      0,         0,         0,     0
img0130.jpg,    0,   0,   0,   0,   0,     0,      0,         0,         0,     0
img0131.jpg,    0,   0,   0,   0,   0,     0,      0,         0,         0,     0
img0132.jpg,    0,   0,   0,   0,   0,     0,      0,         0,         0,     0
img0133.jpg,    0,   0,   0,   0,   0,     0,      0,         0,         0,     0
img0134.jpg,    0,   0,   0,   0,   0,     0,      0,         0,         0,     0
img0135.jpg,    0,   0,   0,   0,   0,     0,      0,         0,         0,     0
img0136.jpg,    0,   0,   0,   0,   0,     0,      0,         0,         0,     0
img0137.jpg,    0,   0,   0,   0,   0,     0,      0,         0,         0,     0
img0138.jpg,    0,   0,   0,   0,   0,     0,      0,         0,         0,     0
img0139.jpg,    0,   0,   0,   0,   0,     0,      0,         0,         0,     0
img0140.jpg,    0,   0,   0,   0,   0,     0,      0,         0,         0,     0
img0141.jpg,    0,   0,   0,   0,   0,     0,      0,         0,         0,     0
img0142.jpg,    0,   0,   0,   0,   0,     0,      0,         0,         0,     0
img0143.jpg,    0,   0,   0,   0,   0,     0,      0,         0,         0,     0
img0144.jpg,    0, 263, 112, 613, 171,   350,     59,     20650,     12576,    12
img0145.jpg,    0, 174, 112, 540, 172,   366,     60,     21960,     14102,    12
img0145.jpg,    1, 553, 140, 576, 162,    23,     22,       506,       414,     1
img0145.jpg,    2, 785, 144, 800, 164,    15,     20,       300,       248,     1
img0146.jpg,    0,  86, 112, 472, 170,   386,     58,     22388,     15229,    13
img0147.jpg,    0,   3, 112, 372, 170,   369,     58,     21402,     14794,    11
img0147.jpg,    1, 619, 132, 659, 172,    40,     40,      1600,       915,     1
img0147.jpg,    2, 665, 129, 716, 169,    51,     40,      2040,      1399,     2
img0147.jpg,    3, 773, 136, 800, 168,    27,     32,       864,       603,     1
img0148.jpg,    0,   0, 112, 275, 170,   275,     58,     15950,     10602,    10
img0148.jpg,    1, 526, 132, 625, 171,    99,     39,      3861,      2919,     4
img0148.jpg,    2, 684, 128, 770, 169,    86,     41,      3526,      2370,     3
img0148.jpg,    3, 770, 128, 800, 167,    30,     39,      1170,       577,     1
img0149.jpg,    0,   0, 116, 174, 169,   174,     53,      9222,      5901,     7
img0149.jpg,    1, 427, 115, 533, 171,   106,     56,      5936,      3742,     3
img0149.jpg,    2, 668, 121, 788, 170,   120,     49,      5880,      3012,     4
img0150.jpg,    0, 337, 116, 443, 171,   106,     55,      5830,      4424,     3
img0150.jpg,    1, 484, 131, 651, 174,   167,     43,      7181,      4248,     7
img0150.jpg,    2, 669, 129, 728, 172,    59,     43,      2537,      1084,     2
img0151.jpg,    0, 141, 113, 247, 171,   106,     58,      6148,      4499,     3
img0151.jpg,    1, 273, 113, 523, 170,   250,     57,     14250,      7856,    10
img0151.jpg,    2, 747, 138, 770, 168,    23,     30,       690,       572,     1
img0152.jpg,    0,  56, 115, 159, 167,   103,     52,      5356,      4053,     3
img0152.jpg,    1, 177, 113, 429, 170,   252,     57,     14364,      8001,     9
img0152.jpg,    2, 665, 137, 683, 169,    18,     32,       576,       271,     1
img0152.jpg,    3, 751, 128, 800, 171,    49,     43,      2107,      1491,     1
img0153.jpg,    0,   0, 118,  74, 175,    74,     57,      4218,      2945,     3
img0153.jpg,    1,  86, 113, 335, 171,   249,     58,     14442,      8215,     9
img0153.jpg,    2, 560, 136, 591, 167,    31,     31,       961,       727,     1
img0153.jpg,    3, 668, 123, 800, 174,   132,     51,      6732,      4062,     5
img0154.jpg,    0,   0, 115, 260, 172,   260,     57,     14820,      8391,    10
img0154.jpg,    1, 462, 130, 496, 167,    34,     37,      1258,       938,     1
img0154.jpg,    2, 575, 131, 660, 173,    85,     42,      3570,      2349,     2
img0154.jpg,    3, 656, 128, 741, 172,    85,     44,      3740,      2188,     3
img0155.jpg,    0,   0, 119, 145, 168,   145,     49,      7105,      4234,     6
img0155.jpg,    1, 148, 145, 164, 168,    16,     23,       368,       241,     1
img0155.jpg,    2, 364, 120, 399, 167,    35,     47,      1645,      1252,     1
img0155.jpg,    3, 483, 131, 630, 171,   147,     40,      5880,      4063,     4
img0155.jpg,    4, 720, 128, 771, 167,    51,     39,      1989,      1159,     2
img0155.jpg,    5, 785, 140, 800, 164,    15,     24,       360,       225,     1
img0156.jpg,    0,   0, 129,  51, 159,    51,     30,      1530,      1006,     1
img0156.jpg,    1, 267, 119, 303, 167,    36,     48,      1728,      1264,     1
img0156.jpg,    2, 393, 112, 564, 170,   171,     58,      9918,      5798,     6
img0156.jpg,    3, 624, 136, 656, 167,    32,     31,       992,       495,     1
img0156.jpg,    4, 666, 147, 680, 167,    14,     20,       280,       166,     1
img0156.jpg,    5, 694, 128, 771, 167,    77,     39,      3003,      1760,     3
img0157.jpg,    0, 172, 120, 206, 167,    34,     47,      1598,      1213,     1
img0157.jpg,    1, 301, 113, 472, 170,   171,     57,      9747,      6594,     6
img0157.jpg,    2, 519, 134, 580, 165,    61,     31,      1891,      1204,     2
img0157.jpg,    3, 597, 134, 627, 167,    30,     33,       990,       562,     1
img0157.jpg,    4, 636, 147, 656, 164,    20,     17,       340,       229,     1
img0158.jpg,    0,  79, 120, 111, 168,    32,     48,      1536,      1117,     1
img0158.jpg,    1, 209, 112, 381, 171,   172,     59,     10148,      6801,     6
img0158.jpg,    2, 416, 118, 479, 165,    63,     47,      2961,      1575,     2
img0158.jpg,    3, 496, 132, 579, 166,    83,     34,      2822,      1653,     3
img0159.jpg,    0, 122, 111, 291, 171,   169,     60,     10140,      7005,     6
img0159.jpg,    1, 313, 119, 376, 164,    63,     45,      2835,      1679,     2
img0159.jpg,    2, 395, 119, 480, 166,    85,     47,      3995,      2107,     3
img0159.jpg,    3, 675, 121, 800, 172,   125,     51,      6375,      4511,     5
img0160.jpg,    0,  38, 112, 202, 172,   164,     60,      9840,      6543,     6
img0160.jpg,    1, 294, 117, 383, 165,    89,     48,      4272,      2557,     3
img0160.jpg,    2, 586, 131, 662, 175,    76,     44,      3344,      2369,     3
img0160.jpg,    3, 667, 120, 768, 175,   101,     55,      5555,      3676,     3
img0161.jpg,    0,   0, 118, 175, 167,   175,     49,      8575,      5503,     6
img0161.jpg,    1, 196, 120, 283, 167,    87,     47,      4089,      2534,     3
img0161.jpg,    2, 495, 131, 657, 175,   162,     44,      7128,      5330,     4
img0161.jpg,    3, 724, 128, 779, 169,    55,     41,      2255,      1413,     2
img0162.jpg,    0,   0, 120,  79, 162,    79,     42,      3318,      1978,     3
img0162.jpg,    1,  99, 120, 181, 164,    82,     44,      3608,      2304,     3
img0162.jpg,    2, 404, 112, 596, 173,   192,     61,     11712,      6838,     5
img0162.jpg,    3, 629, 134, 656, 167,    27,     33,       891,       600,     1
img0162.jpg,    4, 670, 132, 688, 161,    18,     29,       522,       438,     1
img0162.jpg,    5, 779, 137, 800, 169,    21,     32,       672,       559,     1
img0163.jpg,    0,   7, 123,  82, 167,    75,     44,      3300,      1632,     3
img0163.jpg,    1, 312, 112, 504, 172,   192,     60,     11520,      8108,     7
img0163.jpg,    2, 528, 135, 592, 167,    64,     32,      2048,      1419,     2
img0163.jpg,    3, 689, 128, 800, 167,   111,     39,      4329,      2740,     4
img0164.jpg,    0, 221, 112, 415, 173,   194,     61,     11834,      8638,     7
img0164.jpg,    1, 426, 117, 492, 167,    66,     50,      3300,      1887,     2
img0164.jpg,    2, 593, 134, 655, 168,    62,     34,      2108,      1072,     2
img0164.jpg,    3, 669, 129, 724, 167,    55,     38,      2090,      1229,     2
img0165.jpg,    0, 132, 112, 391, 175,   259,     63,     16317,     11040,     9
img0165.jpg,    1, 497, 132, 625, 167,   128,     35,      4480,      2841,     5
img0165.jpg,    2, 780, 136, 800, 168,    20,     32,       640,       475,     1
img0166.jpg,    0,  49, 112, 293, 172,   244,     60,     14640,     10453,     9
img0166.jpg,    1, 400, 117, 535, 167,   135,     50,      6750,      3614,     5
img0167.jpg,    0,   0, 119,  77, 167,    77,     48,      3696,      2659,     3
img0167.jpg,    1, 178, 118, 300, 168,   122,     50,      6100,      4312,     4
img0167.jpg,    2, 486, 131, 581, 170,    95,     39,      3705,      2632,     3
img0167.jpg,    3, 600, 134, 657, 167,    57,     33,      1881,      1235,     1
img0167.jpg,    4, 669, 132, 729, 167,    60,     35,      2100,      1317,     2
img0168.jpg,    0,  86, 119, 201, 167,   115,     48,      5520,      3978,     4
img0168.jpg,    1, 393, 113, 489, 170,    96,     57,      5472,      3314,     3
img0168.jpg,    2, 506, 132, 614, 169,   108,     37,      3996,      2933,     4
img0168.jpg,    3, 752, 128, 800, 170,    48,     42,      2016,      1684,     1
img0169.jpg,    0,   0, 120, 104, 168,   104,     48,      4992,      3367,     4
img0169.jpg,    1, 301, 116, 397, 170,    96,     54,      5184,      3598,     3
img0169.jpg,    2, 409, 113, 544, 168,   135,     55,      7425,      3866,     5
img0169.jpg,    3, 668, 127, 774, 172,   106,     45,      4770,      3498,     4
img0170.jpg,    0, 208, 113, 307, 169,    99,     56,      5544,      3763,     3
img0170.jpg,    1, 313, 115, 451, 168,   138,     53,      7314,      4403,     5
img0170.jpg,    2, 575, 131, 661, 173,    86,     42,      3612,      2426,     3
img0170.jpg,    3, 669, 132, 691, 167,    22,     35,       770,       593,     1
img0170.jpg,    4, 705, 128, 736, 168,    31,     40,      1240,       860,     1
img0171.jpg,    0, 118, 112, 356, 170,   238,     58,     13804,      8491,     8
img0171.jpg,    1, 482, 131, 633, 171,   151,     40,      6040,      3984,     5
img0171.jpg,    2, 780, 136, 800, 168,    20,     32,       640,       488,     1
img0172.jpg,    0,  33, 115, 261, 168,   228,     53,     12084,      8228,     8
img0172.jpg,    1, 391, 113, 543, 170,   152,     57,      8664,      5306,     5
img0173.jpg,    0,   0, 118, 163, 167,   163,     49,      7987,      5337,     6
img0173.jpg,    1, 297, 115, 447, 170,   150,     55,      8250,      6047,     5
img0174.jpg,    0,   0, 125,  71, 167,    71,     42,      2982,      1977,     3
img0174.jpg,    1, 207, 112, 352, 170,   145,     58,      8410,      6163,     5
img0174.jpg,    2, 511, 131, 618, 171,   107,     40,      4280,      3397,     2
img0175.jpg,    0, 108, 113, 248, 172,   140,     59,      8260,      6068,     5
img0175.jpg,    1, 641, 119, 800, 175,   159,     56,      8904,      5793,     6
img0176.jpg,    0,  22, 116, 155, 171,   133,     55,      7315,      5415,     5
img0176.jpg,    1, 313, 115, 416, 171,   103,     56,      5768,      4913,     1
img0176.jpg,    2, 546, 120, 724, 175,   178,     55,      9790,      5627,     5
img0176.jpg,    3, 732, 131, 759, 167,    27,     36,       972,       749,     1
img0177.jpg,    0,   0, 120,  65, 172,    65,     52,      3380,      2623,     3
img0177.jpg,    1, 219, 113, 342, 171,   123,     58,      7134,      5344,     2
img0177.jpg,    2, 451, 130, 629, 175,   178,     45,      8010,      5589,     5
img0177.jpg,    3, 635, 133, 656, 167,    21,     34,       714,       523,     1
img0178.jpg,    0, 127, 112, 248, 171,   121,     59,      7139,      5337,     2
img0178.jpg,    1, 360, 112, 566, 172,   206,     60,     12360,      7639,     6
img0178.jpg,    2, 721, 123, 800, 171,    79,     48,      3792,      2553,     3
img0179.jpg,    0,  37, 114, 151, 170,   114,     56,      6384,      4545,     2
img0179.jpg,    1, 263, 113, 471, 171,   208,     58,     12064,      8930,     6
img0179.jpg,    2, 635, 127, 724, 175,    89,     48,      4272,      2489,     3
img0180.jpg,    0, 170, 112, 375, 171,   205,     59,     12095,      9124,     7
img0180.jpg,    1, 537, 132, 614, 173,    77,     41,      3157,      2431,     2
img0180.jpg,    2, 698, 121, 800, 171,   102,     50,      5100,      2952,     4
img0181.jpg,    0,  79, 112, 280, 170,   201,     58,     11658,      8855,     6
img0181.jpg,    1, 442, 126, 536, 171,    94,     45,      4230,      2849,     3
img0181.jpg,    2, 604, 133, 658, 167,    54,     34,      1836,      1108,     2
img0181.jpg,    3, 665, 129, 725, 168,    60,     39,      2340,      1388,     2
img0182.jpg,    0,   0, 112, 186, 170,   186,     58,     10788,      7791,     6
img0182.jpg,    1, 346, 115, 447, 170,   101,     55,      5555,      3853,     3
img0182.jpg,    2, 505, 132, 619, 169,   114,     37,      4218,      3001,     4
img0183.jpg,    0, 131, 112, 231, 170,   100,     58,      5800,      3939,     4
img0183.jpg,    1, 284, 115, 419, 170,   135,     55,      7425,      4611,     5
img0183.jpg,    2, 627, 120, 800, 173,   173,     53,      9169,      5597,     5
img0184.jpg,    0,  53, 115, 146, 169,    93,     54,      5022,      3584,     4
img0184.jpg,    1, 197, 113, 335, 170,   138,     57,      7866,      4802,     5
img0184.jpg,    2, 410, 113, 481, 170,    71,     57,      4047,      2564,     2
img0184.jpg,    3, 541, 131, 659, 173,   118,     42,      4956,      3596,     3
img0184.jpg,    4, 664, 128, 739, 169,    75,     41,      3075,      2177,     3
img0185.jpg,    0,   0, 116,  68, 171,    68,     55,      3740,      2437,     2
img0185.jpg,    1, 114, 114, 254, 171,   140,     57,      7980,      4886,     5
img0185.jpg,    2, 327, 116, 399, 170,    72,     54,      3888,      2695,     2
img0185.jpg,    3, 457, 130, 654, 172,   197,     42,      8274,      5878,     6
img0185.jpg,    4, 728, 128, 757, 168,    29,     40,      1160,       873,     1
img0186.jpg,    0,  38, 118, 168, 169,   130,     51,      6630,      4252,     5
img0186.jpg,    1, 243, 113, 316, 169,    73,     56,      4088,      2732,     2
img0186.jpg,    2, 376, 112, 575, 171,   199,     59,     11741,      7063,     6
img0186.jpg,    3, 645, 144, 659, 168,    14,     24,       336,       188,     1
img0186.jpg,    4, 730, 126, 800, 168,    70,     42,      2940,      2083,     2
img0187.jpg,    0,   0, 121,  79, 167,    79,     46,      3634,      2167,     3
img0187.jpg,    1, 152, 113, 223, 171,    71,     58,      4118,      2780,     2
img0187.jpg,    2, 283, 113, 483, 171,   200,     58,     11600,      8002,     6
img0187.jpg,    3, 544, 136, 578, 167,    34,     31,      1054,       820,     1
img0187.jpg,    4, 638, 132, 661, 169,    23,     37,       851,       555,     1
img0187.jpg,    5, 669, 120, 800, 167,   131,     47,      6157,      4106,     5
img0188.jpg,    0,  65, 118, 130, 167,    65,     49,      3185,      2350,     2
img0188.jpg,    1, 192, 112, 391, 170,   199,     58,     11542,      8209,     6
img0188.jpg,    2, 445, 128, 479, 167,    34,     39,      1326,       998,     1
img0188.jpg,    3, 541, 133, 625, 168,    84,     35,      2940,      2182,     2
img0188.jpg,    4, 625, 132, 658, 170,    33,     38,      1254,       718,     2
img0188.jpg,    5, 671, 129, 773, 167,   102,     38,      3876,      2759,     4
img0189.jpg,    0, 104, 112, 301, 172,   197,     60,     11820,      8354,     8
img0189.jpg,    1, 345, 120, 380, 167,    35,     47,      1645,      1251,     1
img0189.jpg,    2, 445, 127, 659, 169,   214,     42,      8988,      5289,     7
img0189.jpg,    3, 665, 129, 738, 167,    73,     38,      2774,      1371,     3
img0190.jpg,    0,  17, 115, 210, 173,   193,     58,     11194,      7967,     8
img0190.jpg,    1, 247, 120, 282, 167,    35,     47,      1645,      1283,     1
img0190.jpg,    2, 348, 112, 614, 170,   266,     58,     15428,      8257,     9
img0190.jpg,    3, 725, 132, 752, 167,    27,     35,       945,       611,     1
img0191.jpg,    0,   0, 117, 110, 175,   110,     58,      6380,      4144,     4
img0191.jpg,    1, 141, 120, 175, 167,    34,     47,      1598,      1165,     1
img0191.jpg,    2, 241, 114, 536, 170,   295,     56,     16520,      9537,    10
img0192.jpg,    0,   0, 121,  31, 172,    31,     51,      1581,      1087,     1
img0192.jpg,    1,  49, 121,  80, 165,    31,     44,      1364,      1048,     1
img0192.jpg,    2, 149, 114, 444, 169,   295,     55,     16225,     10137,    10
img0192.jpg,    3, 512, 135, 542, 165,    30,     30,       900,       697,     1
img0192.jpg,    4, 714, 128, 800, 170,    86,     42,      3612,      2687,     3
img0193.jpg,    0,  57, 117, 351, 171,   294,     54,     15876,     10123,    10
img0193.jpg,    1, 409, 127, 468, 164,    59,     37,      2183,      1351,     2
img0193.jpg,    2, 624, 133, 659, 171,    35,     38,      1330,       749,     1
img0193.jpg,    3, 665, 126, 794, 167,   129,     41,      5289,      3664,     5
img0194.jpg,    0,   0, 117, 256, 171,   256,     54,     13824,      8701,     9
img0194.jpg,    1, 304, 120, 366, 164,    62,     44,      2728,      1562,     2
img0194.jpg,    2, 529, 132, 659, 170,   130,     38,      4940,      3666,     4
img0194.jpg,    3, 662, 128, 714, 168,    52,     40,      2080,      1119,     2
img0194.jpg,    4, 736, 133, 763, 166,    27,     33,       891,       650,     1
img0195.jpg,    0,   0, 120, 159, 167,   159,     47,      7473,      4849,     6
img0195.jpg,    1, 203, 123, 262, 165,    59,     42,      2478,      1634,     2
img0195.jpg,    2, 436, 117, 622, 170,   186,     53,      9858,      5521,     7
img0195.jpg,    3, 639, 137, 657, 167,    18,     30,       540,       315,     1
img0195.jpg,    4, 673, 138, 693, 161,    20,     23,       460,       298,     1
img0195.jpg,    5, 771, 140, 798, 167,    27,     27,       729,       443,     1
img0196.jpg,    0,   0, 121,  68, 169,    68,     48,      3264,      1857,     3
img0196.jpg,    1, 105, 123, 159, 164,    54,     41,      2214,      1421,     2
img0196.jpg,    2, 343, 113, 597, 170,   254,     57,     14478,      7966,     9
img0196.jpg,    3, 681, 130, 780, 171,    99,     41,      4059,      2227,     4
img0197.jpg,    0,  13, 128,  61, 166,    48,     38,      1824,      1007,     2
img0197.jpg,    1, 249, 114, 497, 171,   248,     57,     14136,      9077,     9
img0197.jpg,    2, 582, 133, 633, 167,    51,     34,      1734,       969,     2
img0197.jpg,    3, 666, 137, 690, 172,    24,     35,       840,       617,     1
img0197.jpg,    4, 693, 133, 741, 167,    48,     34,      1632,       943,     2
img0198.jpg,    0, 159, 113, 402, 169,   243,     56,     13608,      9396,     8
img0198.jpg,    1, 482, 131, 525, 167,    43,     36,      1548,      1227,     1
img0198.jpg,    2, 545, 134, 610, 170,    65,     36,      2340,      1021,     2
img0198.jpg,    3, 776, 137, 800, 169,    24,     32,       768,       589,     1
img0199.jpg,    0,   0, 119, 201, 170,   201,     51,     10251,      7450,     7
img0199.jpg,    1, 279, 117, 428, 169,   149,     52,      7748,      4570,     5
img0199.jpg,    2, 577, 133, 614, 172,    37,     39,      1443,      1109,     1
img0199.jpg,    3, 641, 136, 656, 167,    15,     31,       465,       204,     1
img0200.jpg,    0,   0, 121,  96, 169,    96,     48,      4608,      3294,     4
img0200.jpg,    1, 177, 113, 320, 171,   143,     58,      8294,      5144,     5
img0200.jpg,    2, 473, 131, 571, 171,    98,     40,      3920,      2700,     4
img0201.jpg,    0,  89, 113, 225, 173,   136,     60,      8160,      4993,     5
img0201.jpg,    1, 379, 113, 480, 169,   101,     56,      5656,      3408,     4
img0201.jpg,    2, 666, 128, 744, 172,    78,     44,      3432,      2473,     3
img0202.jpg,    0,   5, 119, 133, 170,   128,     51,      6528,      4295,     5
img0202.jpg,    1, 285, 116, 388, 169,   103,     53,      5459,      3842,     4
img0202.jpg,    2, 693, 121, 800, 171,   107,     50,      5350,      3224,     4
img0203.jpg,    0, 192, 116, 294, 172,   102,     56,      5712,      3967,     4
img0203.jpg,    1, 476, 131, 575, 171,    99,     40,      3960,      2759,     3
img0203.jpg,    2, 603, 120, 733, 173,   130,     53,      6890,      2925,     5
img0204.jpg,    0, 101, 116, 198, 173,    97,     57,      5529,      3809,     4
img0204.jpg,    1, 384, 113, 482, 170,    98,     57,      5586,      3593,     3
img0204.jpg,    2, 509, 132, 624, 170,   115,     38,      4370,      3015,     4
img0205.jpg,    0, 293, 113, 393, 170,   100,     57,      5700,      3777,     3
img0205.jpg,    1, 416, 113, 552, 170,   136,     57,      7752,      3878,     5
img0205.jpg,    2, 680, 120, 800, 173,   120,     53,      6360,      3962,     5
img0206.jpg,    0, 202, 113, 304, 170,   102,     57,      5814,      3924,     3
img0206.jpg,    1, 323, 114, 466, 169,   143,     55,      7865,      4860,     5
img0206.jpg,    2, 591, 120, 743, 173,   152,     53,      8056,      3866,     6
img0207.jpg,    0, 113, 112, 214, 170,   101,     58,      5858,      3904,     3
img0207.jpg,    1, 228, 113, 372, 170,   144,     57,      8208,      5137,     5
img0207.jpg,    2, 496, 131, 633, 171,   137,     40,      5480,      3798,     5
img0208.jpg,    0,  32, 115, 128, 170,    96,     55,      5280,      3482,     3
img0208.jpg,    1, 137, 112, 273, 171,   136,     59,      8024,      5020,     4
img0208.jpg,    2, 406, 112, 566, 170,   160,     58,      9280,      5196,     5
img0209.jpg,    0,  50, 116, 176, 168,   126,     52,      6552,      4338,     3
img0209.jpg,    1, 314, 113, 478, 171,   164,     58,      9512,      6202,     6
img0209.jpg,    2, 670, 120, 800, 175,   130,     55,      7150,      4741,     4
img0210.jpg,    0, 224, 113, 387, 170,   163,     57,      9291,      6227,     6
img0210.jpg,    1, 578, 131, 661, 175,    83,     44,      3652,      2632,     3
img0210.jpg,    2, 661, 127, 742, 172,    81,     45,      3645,      2451,     3
img0211.jpg,    0, 134, 112, 294, 170,   160,     58,      9280,      6471,     6
img0211.jpg,    1, 488, 131, 656, 172,   168,     41,      6888,      5064,     5
img0212.jpg,    0,  49, 115, 199, 170,   150,     55,      8250,      5689,     5
img0212.jpg,    1, 399, 112, 568, 173,   169,     61,     10309,      6251,     7
img0213.jpg,    0,   0, 118, 105, 171,   105,     53,      5565,      3186,     5
img0213.jpg,    1, 307, 113, 480, 172,   173,     59,     10207,      7392,     7
img0213.jpg,    2, 565, 132, 656, 175,    91,     43,      3913,      2768,     3
img0213.jpg,    3, 667, 129, 687, 162,    20,     33,       660,       384,     1
img0214.jpg,    0,   0, 116, 111, 174,   111,     58,      6438,      4058,     5
img0214.jpg,    1, 137, 113, 227, 171,    90,     58,      5220,      3435,     3
img0214.jpg,    2, 421, 114, 470, 169,    49,     55,      2695,      2005,     1
img0214.jpg,    3, 560, 131, 641, 175,    81,     44,      3564,      2668,     3
img0215.jpg,    0, 257, 114, 305, 171,    48,     57,      2736,      2163,     1
img0215.jpg,    1, 394, 112, 481, 173,    87,     61,      5307,      4108,     1
img0215.jpg,    2, 554, 131, 656, 175,   102,     44,      4488,      3104,     3
img0215.jpg,    3, 715, 120, 800, 172,    85,     52,      4420,      2945,     2
img0216.jpg,    0, 187, 113, 235, 171,    48,     58,      2784,      2156,     1
img0216.jpg,    1, 323, 115, 409, 171,    86,     56,      4816,      4223,     1
img0216.jpg,    2, 481, 131, 592, 172,   111,     41,      4551,      3568,     3
img0216.jpg,    3, 657, 120, 768, 175,   111,     55,      6105,      3401,     5
img0217.jpg,    0, 119, 113, 166, 171,    47,     58,      2726,      2025,     1
img0217.jpg,    1, 252, 113, 340, 171,    88,     58,      5104,      4350,     1
img0217.jpg,    2, 412, 112, 523, 173,   111,     61,      6771,      4461,     3
img0217.jpg,    3, 577, 131, 657, 175,    80,     44,      3520,      2199,     3
img0217.jpg,    4, 665, 131, 703, 169,    38,     38,      1444,       803,     1
img0218.jpg,    0,  56, 118, 101, 168,    45,     50,      2250,      1785,     1
img0218.jpg,    1, 186, 112, 272, 170,    86,     58,      4988,      4352,     1
img0218.jpg,    2, 344, 114, 455, 171,   111,     57,      6327,      4727,     3
img0218.jpg,    3, 510, 133, 618, 172,   108,     39,      4212,      3111,     3
img0218.jpg,    4, 758, 128, 800, 174,    42,     46,      1932,      1616,     1
img0219.jpg,    0,   7, 118,  52, 169,    45,     51,      2295,      1745,     1
img0219.jpg,    1, 133, 112, 217, 173,    84,     61,      5124,      4319,     1
img0219.jpg,    2, 289, 113, 400, 172,   111,     59,      6549,      4819,     2
img0219.jpg,    3, 454, 130, 588, 172,   134,     42,      5628,      3682,     5
img0219.jpg,    4, 706, 121, 784, 172,    78,     51,      3978,      2421,     3
img0220.jpg,    0,   0, 117,  26, 175,    26,     58,      1508,      1177,     1
img0220.jpg,    1, 107, 112, 188, 172,    81,     60,      4860,      4097,     1
img0220.jpg,    2, 262, 112, 371, 172,   109,     60,      6540,      4802,     2
img0220.jpg,    3, 426, 113, 547, 173,   121,     60,      7260,      3830,     4
img0220.jpg,    4, 680, 120, 759, 173,    79,     53,      4187,      2479,     3
